{
  "layout": [
    "##################",
    "#                #",
    "# * * ##### #### #",
    "# * * ##### #### #",
    "# ***            #",
    "# * * #### ##### #",
    "# * * ## # ##### #",
    "#      # #     # #",
    "# #### # ##### # #",
    "# #  # #       # #",
    "#   ## ####### # #",
    "# # #            #",
    "# # # ***** ######",
    "# #     *        #",
    "# ### # * ###### #",
    "#     # * #    # #",
    "# ###   * #    # #",
    "# ### # * ###### #",
    "#     #          #",
    "# ###### ## #### #",
    "# #         # ## #",
    "#   #### #### ## #",
    "# #    #         #",
    "# # ## # ####### #",
    "# #  #        ## #",
    "# #### ## # * ## #",
    "#           * ## #",
    "# ######### * ## #",
    "# #       # *    #",
    "# ######### **** #",
    "#                #",
    "##################"
  ],
  "key": {
    "#": {
      "type": "wall",
      "args": {
        "color": "#0000ff"
      }
    },
    "*": {
      "type": "wall",
      "args": {
        "color": "#00ff00"
      }
    }
  }
}