##################
#                #
# # # ##### #### #
# # # ##### #### #
# ###            #
# # # #### ##### #
# # # ## # ##### #
#      # #     # #
# #### # ##### # #
# #  # #       # #
#   ## ####### # #
# # #            #
# # # ##### ######
# #     #        #
# ### # # ###### #
#     # # #    # #
# ###   # #    # #
# ### # # ###### #
#     #          #
# ###### ## #### #
# #         # ## #
#   #### #### ## #
# #    #         #
# # ## # ####### #
# #  #        ## #
# #### ## # # ## #
#           # ## #
# ######### # ## #
# #       # #    #
# ######### #### #
#                #
##################