{
  "layout": [
    "#####I############",
    "#S              S#",
    "# * * ##### #### #",
    "# * * ##### #### #",
    "# ***            #",
    "# * * #### ##### #",
    "# * * ##S# ##### #",
    "#      # #    S# #",
    "# #### # ##### # #",
    "# # S# #       # #",
    "#   ## ####### # #",
    "# # #            #",
    "# # # ***** ######",
    "# #    S*       S#",
    "# ### # * ###### #",
    "#     # * #    # #",
    "# ###   * #    # #",
    "# ### # * ###### #",
    "#    S#          #",
    "# ###### ## #### #",
    "# #         #S## #",
    "#   #### #### ## #",
    "# #    #         #",
    "# # ## # ####### #",
    "# # S#        ## #",
    "# #### ## # * ## #",
    "#           * ## #",
    "# ######### * ## #",
    "# #       # *    #",
    "# ######### **** #",
    "#S              S#",
    "##################"
  ],
  "key": {
    "#": {
      "type": "wall",
      "args": {
        "color": "#0000ff"
      }
    },
    "*": {
      "type": "wall",
      "args": {
        "color": "#00ff00"
      }
    },
    "I": {
      "type": "wall",
      "args": {
        "color": "#000000"
      }
    },
    "S": {
      "type": "star"
    }
  }
}